post_id,date,post_type,likes,shares,comments,total_engagement
POST_0115,2024-10-07,reels,475,39,16,530
POST_0156,2024-10-07,reels,136,31,16,183
POST_0204,2024-10-07,reels,959,71,48,1078
POST_0341,2024-10-07,carousel,1105,50,40,1195
POST_0367,2024-10-07,carousel,326,49,40,415
POST_0395,2024-10-07,static_image,387,41,38,466
POST_0444,2024-10-07,carousel,724,84,14,822
POST_0495,2024-10-07,reels,653,69,48,770
POST_0570,2024-10-07,carousel,1099,60,21,1180
POST_0782,2024-10-07,static_image,211,55,32,298
POST_0852,2024-10-07,reels,818,36,28,882
POST_0951,2024-10-07,reels,599,90,78,767
POST_0159,2024-10-08,reels,573,91,36,700
POST_0185,2024-10-08,reels,600,11,56,667
POST_0410,2024-10-08,carousel,452,62,41,555
POST_0538,2024-10-08,carousel,462,21,37,520
POST_0587,2024-10-08,static_image,217,82,43,342
POST_0669,2024-10-08,carousel,602,74,23,699
POST_0692,2024-10-08,static_image,112,42,28,182
POST_0717,2024-10-08,static_image,274,43,41,358
POST_0738,2024-10-08,reels,521,36,76,633
POST_0998,2024-10-08,reels,113,84,72,269
POST_0048,2024-10-09,static_image,184,28,23,235
POST_0090,2024-10-09,carousel,567,106,10,683
POST_0147,2024-10-09,static_image,525,19,36,580
POST_0238,2024-10-09,carousel,484,63,32,579
POST_0292,2024-10-09,carousel,150,21,19,190
POST_0323,2024-10-09,static_image,447,14,24,485
POST_0484,2024-10-09,static_image,167,95,19,281
POST_0523,2024-10-09,reels,914,47,38,999
POST_0595,2024-10-09,carousel,644,32,40,716
POST_0730,2024-10-09,static_image,461,66,30,557
POST_0969,2024-10-09,reels,721,22,62,805
POST_0975,2024-10-09,carousel,808,37,10,855
POST_0146,2024-10-10,static_image,656,67,35,758
POST_0241,2024-10-10,carousel,732,55,24,811
POST_0431,2024-10-10,carousel,750,14,28,792
POST_0516,2024-10-10,reels,174,66,54,294
POST_0566,2024-10-10,carousel,177,66,12,255
POST_0574,2024-10-10,carousel,271,66,49,386
POST_0676,2024-10-10,reels,129,72,16,217
POST_0712,2024-10-10,reels,983,33,66,1082
POST_0736,2024-10-10,carousel,942,42,9,993
POST_0784,2024-10-10,static_image,520,10,7,537
POST_0921,2024-10-10,reels,274,74,66,414
POST_1000,2024-10-10,static_image,793,91,27,911
POST_0033,2024-10-11,static_image,117,10,18,145
POST_0108,2024-10-11,carousel,447,49,36,532
POST_0150,2024-10-11,carousel,747,57,6,810
POST_0234,2024-10-11,reels,704,19,32,755
POST_0640,2024-10-11,static_image,786,13,11,810
POST_0660,2024-10-11,reels,144,70,46,260
POST_0719,2024-10-11,static_image,618,66,16,700
POST_0774,2024-10-11,carousel,1186,88,21,1295
POST_0842,2024-10-11,reels,780,78,44,902
POST_0968,2024-10-11,reels,784,37,50,871
POST_0021,2024-10-12,carousel,886,62,48,996
POST_0084,2024-10-12,static_image,597,53,34,684
POST_0164,2024-10-12,static_image,558,67,27,652
POST_0165,2024-10-12,reels,581,55,76,712
POST_0261,2024-10-12,carousel,936,117,17,1070
POST_0303,2024-10-12,reels,419,44,22,485
POST_0541,2024-10-12,static_image,167,17,6,190
POST_0633,2024-10-12,static_image,575,14,21,610
POST_0988,2024-10-12,reels,532,41,38,611
POST_0996,2024-10-12,static_image,414,14,25,453
POST_0022,2024-10-13,static_image,278,63,28,369
POST_0113,2024-10-13,carousel,549,111,9,669
POST_0181,2024-10-13,carousel,762,82,7,851
POST_0183,2024-10-13,reels,554,26,96,676
POST_0239,2024-10-13,static_image,818,15,48,881
POST_0321,2024-10-13,carousel,598,25,12,635
POST_0330,2024-10-13,static_image,934,61,27,1022
POST_0470,2024-10-13,carousel,652,60,37,749
POST_0501,2024-10-13,carousel,430,94,23,547
POST_0559,2024-10-13,carousel,819,115,42,976
POST_0608,2024-10-13,carousel,1171,70,9,1250
POST_0614,2024-10-13,reels,584,46,92,722
POST_0038,2024-10-14,static_image,977,43,37,1057
POST_0047,2024-10-14,static_image,429,16,37,482
POST_0077,2024-10-14,reels,505,78,74,657
POST_0127,2024-10-14,carousel,744,34,46,824
POST_0140,2024-10-14,reels,139,86,98,323
POST_0331,2024-10-14,reels,295,91,20,406
POST_0333,2024-10-14,reels,415,21,92,528
POST_0372,2024-10-14,reels,653,30,92,775
POST_0424,2024-10-14,static_image,854,79,23,956
POST_0855,2024-10-14,carousel,661,88,23,772
POST_0915,2024-10-14,static_image,733,19,40,792
POST_0126,2024-10-15,carousel,1046,75,27,1148
POST_0168,2024-10-15,static_image,896,38,15,949
POST_0263,2024-10-15,carousel,507,15,42,564
POST_0322,2024-10-15,static_image,755,39,49,843
POST_0345,2024-10-15,carousel,763,105,8,876
POST_0462,2024-10-15,carousel,758,92,37,887
POST_0565,2024-10-15,static_image,531,93,17,641
POST_0593,2024-10-15,reels,456,94,70,620
POST_0606,2024-10-15,carousel,589,51,16,656
POST_0662,2024-10-15,carousel,568,51,46,665
POST_0931,2024-10-15,carousel,873,49,30,952
POST_0962,2024-10-15,static_image,306,89,21,416
POST_0046,2024-10-16,static_image,922,57,22,1001
POST_0083,2024-10-16,reels,124,48,78,250
POST_0099,2024-10-16,reels,322,48,78,448
POST_0232,2024-10-16,carousel,482,48,15,545
POST_0273,2024-10-16,reels,427,57,12,496
POST_0344,2024-10-16,static_image,124,22,38,184
POST_0517,2024-10-16,reels,372,78,96,546
POST_0636,2024-10-16,reels,794,84,74,952
POST_0643,2024-10-16,static_image,674,47,7,728
POST_0763,2024-10-16,static_image,975,22,49,1046
POST_0766,2024-10-16,carousel,844,96,7,947
POST_0868,2024-10-16,static_image,172,36,30,238
POST_0075,2024-10-17,carousel,343,57,44,444
POST_0236,2024-10-17,static_image,612,66,24,702
POST_0361,2024-10-17,carousel,836,16,6,858
POST_0512,2024-10-17,reels,230,85,64,379
POST_0563,2024-10-17,reels,548,66,66,680
POST_0624,2024-10-17,static_image,484,72,28,584
POST_0630,2024-10-17,carousel,854,54,23,931
POST_0657,2024-10-17,static_image,364,43,18,425
POST_0699,2024-10-17,carousel,370,26,40,436
POST_0773,2024-10-17,static_image,814,50,45,909
POST_0820,2024-10-17,carousel,320,110,5,435
POST_0832,2024-10-17,reels,149,28,52,229
POST_0149,2024-10-18,static_image,181,11,18,210
POST_0433,2024-10-18,reels,635,43,68,746
POST_0457,2024-10-18,static_image,262,64,32,358
POST_0472,2024-10-18,carousel,511,114,37,662
POST_0480,2024-10-18,reels,687,97,88,872
POST_0511,2024-10-18,carousel,988,116,38,1142
POST_0629,2024-10-18,carousel,742,44,9,795
POST_0693,2024-10-18,static_image,884,77,29,990
POST_0777,2024-10-18,static_image,687,35,23,745
POST_0843,2024-10-18,reels,567,50,62,679
POST_0974,2024-10-18,carousel,766,20,5,791
POST_0991,2024-10-18,carousel,200,84,33,317
POST_0092,2024-10-19,static_image,670,35,45,750
POST_0134,2024-10-19,carousel,674,58,29,761
POST_0285,2024-10-19,carousel,538,100,11,649
POST_0476,2024-10-19,reels,593,79,76,748
POST_0493,2024-10-19,carousel,315,112,12,439
POST_0505,2024-10-19,reels,605,68,62,735
POST_0663,2024-10-19,reels,287,75,12,374
POST_0809,2024-10-19,static_image,195,48,10,253
POST_0823,2024-10-19,static_image,815,89,47,951
POST_0987,2024-10-19,reels,265,40,36,341
POST_0014,2024-10-20,reels,519,63,54,636
POST_0397,2024-10-20,reels,282,82,58,422
POST_0425,2024-10-20,carousel,956,15,8,979
POST_0613,2024-10-20,static_image,224,24,34,282
POST_0656,2024-10-20,static_image,293,72,44,409
POST_0683,2024-10-20,reels,875,50,20,945
POST_0714,2024-10-20,reels,932,93,64,1089
POST_0759,2024-10-20,carousel,733,44,46,823
POST_0775,2024-10-20,reels,453,50,66,569
POST_0799,2024-10-20,static_image,305,66,40,411
POST_0808,2024-10-20,static_image,187,75,44,306
POST_0999,2024-10-20,static_image,288,27,31,346
POST_0169,2024-10-21,reels,786,87,48,921
POST_0293,2024-10-21,reels,477,51,24,552
POST_0317,2024-10-21,reels,570,39,24,633
POST_0418,2024-10-21,reels,590,98,28,716
POST_0463,2024-10-21,static_image,618,79,19,716
POST_0483,2024-10-21,static_image,376,29,30,435
POST_0491,2024-10-21,static_image,808,60,15,883
POST_0575,2024-10-21,carousel,320,33,16,369
POST_0753,2024-10-21,carousel,861,62,20,943
POST_0756,2024-10-21,static_image,692,68,24,784
POST_0919,2024-10-21,static_image,608,18,37,663
POST_0035,2024-10-22,carousel,255,56,8,319
POST_0100,2024-10-22,reels,542,26,36,604
POST_0387,2024-10-22,reels,451,17,28,496
POST_0455,2024-10-22,carousel,776,112,34,922
POST_0494,2024-10-22,static_image,658,24,44,726
POST_0537,2024-10-22,reels,536,70,80,686
POST_0592,2024-10-22,carousel,492,64,19,575
POST_0677,2024-10-22,carousel,189,115,12,316
POST_0716,2024-10-22,static_image,601,62,46,709
POST_0923,2024-10-22,reels,192,57,34,283
POST_0132,2024-10-23,static_image,640,18,7,665
POST_0192,2024-10-23,carousel,824,66,36,926
POST_0270,2024-10-23,carousel,1002,52,48,1102
POST_0464,2024-10-23,reels,771,84,48,903
POST_0515,2024-10-23,reels,140,60,44,244
POST_0618,2024-10-23,reels,167,78,82,327
POST_0698,2024-10-23,reels,326,80,90,496
POST_0703,2024-10-23,carousel,313,21,28,362
POST_0819,2024-10-23,static_image,950,15,37,1002
POST_0833,2024-10-23,carousel,1188,90,34,1312
POST_0896,2024-10-23,static_image,720,56,24,800
POST_0051,2024-10-24,static_image,845,11,7,863
POST_0054,2024-10-24,carousel,390,74,48,512
POST_0117,2024-10-24,carousel,820,28,28,876
POST_0369,2024-10-24,static_image,407,64,30,501
POST_0461,2024-10-24,static_image,695,91,47,833
POST_0486,2024-10-24,reels,480,49,64,593
POST_0642,2024-10-24,carousel,1137,108,37,1282
POST_0720,2024-10-24,static_image,472,86,11,569
POST_0746,2024-10-24,static_image,432,59,15,506
POST_0826,2024-10-24,static_image,305,65,7,377
POST_0973,2024-10-24,reels,968,93,32,1093
POST_0119,2024-10-25,static_image,479,79,43,601
POST_0142,2024-10-25,carousel,804,81,45,930
POST_0180,2024-10-25,static_image,448,73,48,569
POST_0198,2024-10-25,static_image,293,47,43,383
POST_0326,2024-10-25,static_image,899,42,20,961
POST_0378,2024-10-25,carousel,1144,116,49,1309
POST_0422,2024-10-25,reels,701,67,32,800
POST_0604,2024-10-25,static_image,768,83,22,873
POST_0778,2024-10-25,carousel,958,96,11,1065
POST_0834,2024-10-25,static_image,778,77,37,892
POST_0943,2024-10-25,static_image,845,76,23,944
POST_0122,2024-10-26,static_image,683,29,33,745
POST_0194,2024-10-26,carousel,975,58,36,1069
POST_0235,2024-10-26,reels,460,10,18,488
POST_0310,2024-10-26,carousel,896,94,45,1035
POST_0400,2024-10-26,static_image,785,30,39,854
POST_0508,2024-10-26,carousel,690,21,42,753
POST_0509,2024-10-26,reels,745,92,96,933
POST_0543,2024-10-26,static_image,354,64,20,438
POST_0591,2024-10-26,carousel,440,52,47,539
POST_0850,2024-10-26,static_image,695,75,34,804
POST_0950,2024-10-26,carousel,1114,57,36,1207
POST_0201,2024-10-27,static_image,416,76,10,502
POST_0382,2024-10-27,carousel,640,39,39,718
POST_0419,2024-10-27,carousel,1194,66,43,1303
POST_0729,2024-10-27,reels,332,26,60,418
POST_0735,2024-10-27,reels,799,66,70,935
POST_0764,2024-10-27,reels,839,18,62,919
POST_0870,2024-10-27,carousel,168,61,24,253
POST_0878,2024-10-27,static_image,418,86,7,511
POST_0895,2024-10-27,carousel,975,36,11,1022
POST_0977,2024-10-27,carousel,1112,66,10,1188
POST_0175,2024-10-28,reels,991,47,38,1076
POST_0227,2024-10-28,reels,433,11,82,526
POST_0311,2024-10-28,static_image,807,22,6,835
POST_0376,2024-10-28,carousel,459,100,38,597
POST_0453,2024-10-28,reels,908,63,96,1067
POST_0504,2024-10-28,carousel,313,15,32,360
POST_0507,2024-10-28,carousel,918,16,39,973
POST_0620,2024-10-28,carousel,1143,74,27,1244
POST_0916,2024-10-28,reels,812,37,30,879
POST_0933,2024-10-28,carousel,230,114,20,364
POST_0123,2024-10-29,static_image,409,83,47,539
POST_0176,2024-10-29,reels,262,73,58,393
POST_0294,2024-10-29,carousel,303,55,8,366
POST_0307,2024-10-29,reels,201,51,72,324
POST_0318,2024-10-29,reels,911,67,80,1058
POST_0363,2024-10-29,static_image,760,19,27,806
POST_0469,2024-10-29,carousel,564,117,25,706
POST_0678,2024-10-29,reels,111,40,36,187
POST_0697,2024-10-29,carousel,544,67,22,633
POST_0787,2024-10-29,carousel,762,39,46,847
POST_0836,2024-10-29,static_image,314,23,27,364
POST_0081,2024-10-30,reels,600,82,26,708
POST_0255,2024-10-30,reels,747,56,88,891
POST_0265,2024-10-30,carousel,453,110,49,612
POST_0280,2024-10-30,carousel,288,114,23,425
POST_0325,2024-10-30,reels,505,91,24,620
POST_0532,2024-10-30,reels,253,96,52,401
POST_0585,2024-10-30,carousel,361,90,15,466
POST_0648,2024-10-30,reels,780,33,78,891
POST_0695,2024-10-30,static_image,822,21,41,884
POST_0795,2024-10-30,static_image,943,47,40,1030
POST_0888,2024-10-30,reels,965,72,52,1089
POST_0129,2024-10-31,static_image,259,22,29,310
POST_0152,2024-10-31,carousel,550,82,28,660
POST_0202,2024-10-31,carousel,1047,98,43,1188
POST_0216,2024-10-31,reels,306,16,32,354
POST_0354,2024-10-31,carousel,237,36,13,286
POST_0467,2024-10-31,reels,120,91,18,229
POST_0542,2024-10-31,carousel,883,114,45,1042
POST_0619,2024-10-31,carousel,484,26,38,548
POST_0639,2024-10-31,static_image,830,91,32,953
POST_0863,2024-10-31,carousel,403,66,46,515
POST_0034,2024-11-01,static_image,274,75,32,381
POST_0245,2024-11-01,reels,375,62,56,493
POST_0352,2024-11-01,reels,878,59,70,1007
POST_0365,2024-11-01,carousel,134,112,30,276
POST_0544,2024-11-01,carousel,193,68,34,295
POST_0610,2024-11-01,static_image,656,13,30,699
POST_0726,2024-11-01,static_image,317,13,30,360
POST_0750,2024-11-01,carousel,447,33,27,507
POST_0828,2024-11-01,carousel,254,25,15,294
POST_0892,2024-11-01,static_image,228,64,7,299
POST_0064,2024-11-02,reels,116,46,58,220
POST_0072,2024-11-02,reels,462,74,80,616
POST_0120,2024-11-02,static_image,401,97,15,513
POST_0133,2024-11-02,carousel,1004,102,46,1152
POST_0182,2024-11-02,reels,626,34,68,728
POST_0250,2024-11-02,reels,845,17,50,912
POST_0471,2024-11-02,reels,728,77,92,897
POST_0686,2024-11-02,static_image,236,36,38,310
POST_0829,2024-11-02,carousel,458,25,21,504
POST_0981,2024-11-02,carousel,337,56,31,424
POST_0157,2024-11-03,reels,423,73,42,538
POST_0158,2024-11-03,reels,500,19,10,529
POST_0196,2024-11-03,carousel,1012,103,34,1149
POST_0229,2024-11-03,static_image,183,11,43,237
POST_0272,2024-11-03,reels,876,12,50,938
POST_0314,2024-11-03,reels,911,67,14,992
POST_0426,2024-11-03,reels,635,35,82,752
POST_0473,2024-11-03,carousel,915,84,38,1037
POST_0652,2024-11-03,static_image,678,74,40,792
POST_0704,2024-11-03,static_image,903,27,7,937
POST_0788,2024-11-03,static_image,389,66,27,482
POST_0797,2024-11-03,static_image,925,59,34,1018
POST_0039,2024-11-04,static_image,154,41,11,206
POST_0193,2024-11-04,static_image,691,63,26,780
POST_0210,2024-11-04,static_image,849,54,12,915
POST_0224,2024-11-04,static_image,336,27,44,407
POST_0225,2024-11-04,carousel,1003,42,12,1057
POST_0342,2024-11-04,static_image,881,74,20,975
POST_0348,2024-11-04,reels,927,72,20,1019
POST_0388,2024-11-04,reels,722,90,70,882
POST_0437,2024-11-04,carousel,1160,87,23,1270
POST_0448,2024-11-04,reels,646,55,60,761
POST_0655,2024-11-04,carousel,271,12,40,323
POST_0882,2024-11-04,carousel,472,82,32,586
POST_0186,2024-11-05,static_image,163,86,21,270
POST_0228,2024-11-05,carousel,782,85,18,885
POST_0251,2024-11-05,carousel,1050,45,36,1131
POST_0269,2024-11-05,static_image,927,98,37,1062
POST_0289,2024-11-05,reels,874,63,10,947
POST_0401,2024-11-05,reels,643,48,32,723
POST_0475,2024-11-05,reels,276,26,76,378
POST_0589,2024-11-05,carousel,735,56,7,798
POST_0668,2024-11-05,carousel,398,46,17,461
POST_0694,2024-11-05,reels,812,30,48,890
POST_0818,2024-11-05,reels,773,70,16,859
POST_0902,2024-11-05,static_image,963,14,40,1017
POST_0017,2024-11-06,carousel,283,99,30,412
POST_0105,2024-11-06,reels,496,91,74,661
POST_0118,2024-11-06,static_image,904,70,41,1015
POST_0171,2024-11-06,carousel,577,78,32,687
POST_0222,2024-11-06,reels,873,48,92,1013
POST_0481,2024-11-06,reels,670,19,78,767
POST_0586,2024-11-06,carousel,438,27,22,487
POST_0600,2024-11-06,static_image,659,41,40,740
POST_0653,2024-11-06,carousel,777,12,19,808
POST_0803,2024-11-06,static_image,261,18,21,300
POST_0904,2024-11-06,carousel,1176,112,13,1301
POST_0086,2024-11-07,carousel,171,81,21,273
POST_0167,2024-11-07,carousel,705,57,19,781
POST_0203,2024-11-07,static_image,515,50,16,581
POST_0231,2024-11-07,reels,262,14,10,286
POST_0296,2024-11-07,static_image,301,98,22,421
POST_0346,2024-11-07,carousel,133,49,36,218
POST_0641,2024-11-07,carousel,314,68,13,395
POST_0661,2024-11-07,static_image,457,25,6,488
POST_0811,2024-11-07,reels,862,50,66,978
POST_0816,2024-11-07,reels,468,92,94,654
POST_0899,2024-11-07,reels,634,34,50,718
POST_0992,2024-11-07,static_image,118,52,6,176
POST_0015,2024-11-08,carousel,120,86,44,250
POST_0095,2024-11-08,static_image,893,94,26,1013
POST_0258,2024-11-08,static_image,753,62,9,824
POST_0259,2024-11-08,carousel,841,85,32,958
POST_0309,2024-11-08,carousel,542,54,7,603
POST_0398,2024-11-08,static_image,945,98,26,1069
POST_0446,2024-11-08,carousel,1153,94,21,1268
POST_0465,2024-11-08,static_image,298,30,46,374
POST_0596,2024-11-08,static_image,528,82,42,652
POST_0734,2024-11-08,static_image,932,58,42,1032
POST_0887,2024-11-08,reels,351,46,38,435
POST_0028,2024-11-09,static_image,800,58,11,869
POST_0306,2024-11-09,carousel,669,39,23,731
POST_0371,2024-11-09,static_image,844,61,33,938
POST_0528,2024-11-09,reels,987,55,84,1126
POST_0546,2024-11-09,static_image,760,78,24,862
POST_0557,2024-11-09,reels,591,75,56,722
POST_0638,2024-11-09,static_image,814,73,21,908
POST_0711,2024-11-09,static_image,486,26,16,528
POST_0739,2024-11-09,static_image,835,70,25,930
POST_0874,2024-11-09,reels,395,84,14,493
POST_0893,2024-11-09,reels,853,10,84,947
POST_0024,2024-11-10,carousel,331,45,47,423
POST_0053,2024-11-10,carousel,1084,56,34,1174
POST_0074,2024-11-10,static_image,395,20,40,455
POST_0138,2024-11-10,carousel,830,58,49,937
POST_0300,2024-11-10,reels,531,46,38,615
POST_0447,2024-11-10,static_image,976,60,23,1059
POST_0530,2024-11-10,static_image,641,87,24,752
POST_0581,2024-11-10,reels,772,45,44,861
POST_0859,2024-11-10,reels,513,34,98,645
POST_0860,2024-11-10,carousel,1176,64,8,1248
POST_0894,2024-11-10,reels,440,38,18,496
POST_0980,2024-11-10,reels,357,17,30,404
POST_0041,2024-11-11,static_image,542,81,41,664
POST_0155,2024-11-11,reels,930,37,38,1005
POST_0247,2024-11-11,carousel,165,78,47,290
POST_0268,2024-11-11,reels,810,24,50,884
POST_0536,2024-11-11,static_image,735,28,18,781
POST_0554,2024-11-11,carousel,921,72,8,1001
POST_0571,2024-11-11,carousel,1101,81,43,1225
POST_0666,2024-11-11,static_image,731,64,31,826
POST_0944,2024-11-11,static_image,793,87,44,924
POST_0947,2024-11-11,reels,161,58,26,245
POST_0984,2024-11-11,static_image,499,22,39,560
POST_0088,2024-11-12,reels,691,97,46,834
POST_0215,2024-11-12,reels,854,44,66,964
POST_0249,2024-11-12,static_image,483,54,20,557
POST_0312,2024-11-12,carousel,632,43,36,711
POST_0414,2024-11-12,static_image,380,17,46,443
POST_0438,2024-11-12,carousel,1006,76,37,1119
POST_0673,2024-11-12,reels,663,29,72,764
POST_0776,2024-11-12,carousel,426,24,25,475
POST_0831,2024-11-12,reels,168,68,74,310
POST_0845,2024-11-12,reels,197,98,78,373
POST_0884,2024-11-12,reels,667,68,50,785
POST_0966,2024-11-12,carousel,405,91,42,538
POST_0001,2024-11-13,carousel,274,43,35,352
POST_0178,2024-11-13,reels,756,62,24,842
POST_0248,2024-11-13,reels,527,47,48,622
POST_0445,2024-11-13,reels,870,86,94,1050
POST_0558,2024-11-13,reels,446,64,90,600
POST_0564,2024-11-13,carousel,1022,58,18,1098
POST_0576,2024-11-13,carousel,249,25,37,311
POST_0767,2024-11-13,carousel,846,52,39,937
POST_0768,2024-11-13,carousel,549,118,18,685
POST_0798,2024-11-13,reels,968,34,62,1064
POST_0837,2024-11-13,static_image,227,63,33,323
POST_0982,2024-11-13,static_image,898,70,14,982
POST_0139,2024-11-14,reels,448,67,14,529
POST_0188,2024-11-14,reels,594,47,72,713
POST_0253,2024-11-14,carousel,492,118,47,657
POST_0262,2024-11-14,carousel,1027,103,35,1165
POST_0327,2024-11-14,reels,599,23,80,702
POST_0368,2024-11-14,carousel,715,82,15,812
POST_0428,2024-11-14,static_image,504,83,42,629
POST_0489,2024-11-14,carousel,783,18,43,844
POST_0579,2024-11-14,reels,530,96,48,674
POST_0601,2024-11-14,carousel,933,51,32,1016
POST_0061,2024-11-15,reels,128,96,82,306
POST_0094,2024-11-15,reels,115,80,42,237
POST_0166,2024-11-15,carousel,738,108,39,885
POST_0177,2024-11-15,reels,370,89,62,521
POST_0195,2024-11-15,reels,964,11,74,1049
POST_0366,2024-11-15,reels,592,94,44,730
POST_0535,2024-11-15,carousel,511,104,13,628
POST_0612,2024-11-15,reels,662,59,20,741
POST_0650,2024-11-15,static_image,469,17,30,516
POST_0732,2024-11-15,static_image,560,62,12,634
POST_0835,2024-11-15,carousel,219,75,11,305
POST_0865,2024-11-15,reels,469,36,78,583
POST_0016,2024-11-16,static_image,760,56,13,829
POST_0059,2024-11-16,carousel,549,98,26,673
POST_0385,2024-11-16,static_image,490,37,47,574
POST_0427,2024-11-16,reels,568,63,88,719
POST_0432,2024-11-16,carousel,522,80,8,610
POST_0456,2024-11-16,reels,513,95,64,672
POST_0531,2024-11-16,carousel,456,58,28,542
POST_0617,2024-11-16,static_image,530,26,49,605
POST_0785,2024-11-16,static_image,379,36,44,459
POST_0885,2024-11-16,reels,544,67,94,705
POST_0040,2024-11-17,carousel,128,88,7,223
POST_0098,2024-11-17,reels,926,96,66,1088
POST_0125,2024-11-17,carousel,726,14,10,750
POST_0128,2024-11-17,static_image,789,91,21,901
POST_0144,2024-11-17,carousel,322,86,31,439
POST_0320,2024-11-17,reels,545,39,40,624
POST_0405,2024-11-17,static_image,355,95,26,476
POST_0553,2024-11-17,reels,331,30,84,445
POST_0741,2024-11-17,reels,697,71,44,812
POST_0817,2024-11-17,static_image,587,87,37,711
POST_0938,2024-11-17,carousel,397,32,6,435
POST_0954,2024-11-17,carousel,1192,18,33,1243
POST_0068,2024-11-18,static_image,267,21,49,337
POST_0295,2024-11-18,reels,763,28,80,871
POST_0380,2024-11-18,carousel,223,20,17,260
POST_0390,2024-11-18,reels,660,45,16,721
POST_0522,2024-11-18,carousel,1029,115,7,1151
POST_0582,2024-11-18,carousel,909,44,44,997
POST_0631,2024-11-18,static_image,163,20,49,232
POST_0664,2024-11-18,reels,112,65,70,247
POST_0713,2024-11-18,static_image,508,69,30,607
POST_0740,2024-11-18,reels,552,15,84,651
POST_0898,2024-11-18,carousel,354,25,31,410
POST_0989,2024-11-18,static_image,541,12,20,573
POST_0023,2024-11-19,carousel,334,94,28,456
POST_0335,2024-11-19,reels,315,39,36,390
POST_0394,2024-11-19,reels,473,22,72,567
POST_0435,2024-11-19,carousel,501,110,26,637
POST_0521,2024-11-19,static_image,553,82,24,659
POST_0621,2024-11-19,static_image,998,51,38,1087
POST_0725,2024-11-19,reels,511,86,38,635
POST_0806,2024-11-19,static_image,968,74,29,1071
POST_0928,2024-11-19,reels,916,62,10,988
POST_0978,2024-11-19,carousel,186,81,44,311
POST_0018,2024-11-20,carousel,1082,86,29,1197
POST_0052,2024-11-20,static_image,218,21,24,263
POST_0205,2024-11-20,reels,210,16,30,256
POST_0243,2024-11-20,reels,584,68,18,670
POST_0256,2024-11-20,carousel,824,97,29,950
POST_0393,2024-11-20,carousel,930,25,31,986
POST_0499,2024-11-20,carousel,382,12,12,406
POST_0560,2024-11-20,reels,313,34,44,391
POST_0866,2024-11-20,static_image,440,34,32,506
POST_0986,2024-11-20,reels,607,57,78,742
POST_0093,2024-11-21,carousel,764,67,36,867
POST_0163,2024-11-21,reels,978,88,72,1138
POST_0209,2024-11-21,carousel,763,64,23,850
POST_0276,2024-11-21,static_image,142,57,27,226
POST_0358,2024-11-21,reels,330,59,82,471
POST_0561,2024-11-21,carousel,806,25,10,841
POST_0718,2024-11-21,reels,490,34,74,598
POST_0749,2024-11-21,reels,431,20,82,533
POST_0825,2024-11-21,static_image,613,31,41,685
POST_0862,2024-11-21,static_image,996,19,40,1055
POST_0900,2024-11-21,carousel,501,73,28,602
POST_0967,2024-11-21,static_image,321,70,5,396
POST_0179,2024-11-22,static_image,126,55,11,192
POST_0187,2024-11-22,carousel,447,87,22,556
POST_0211,2024-11-22,carousel,876,74,36,986
POST_0271,2024-11-22,reels,366,81,36,483
POST_0389,2024-11-22,carousel,513,90,19,622
POST_0403,2024-11-22,reels,760,17,88,865
POST_0594,2024-11-22,carousel,453,39,42,534
POST_0626,2024-11-22,static_image,534,26,39,599
POST_0710,2024-11-22,reels,948,23,28,999
POST_0722,2024-11-22,static_image,875,96,29,1000
POST_0993,2024-11-22,reels,672,52,58,782
POST_0025,2024-11-23,reels,765,37,50,852
POST_0069,2024-11-23,carousel,1104,96,14,1214
POST_0107,2024-11-23,reels,645,39,34,718
POST_0124,2024-11-23,reels,924,99,90,1113
POST_0174,2024-11-23,carousel,662,14,5,681
POST_0282,2024-11-23,carousel,1020,44,39,1103
POST_0430,2024-11-23,carousel,261,96,8,365
POST_0503,2024-11-23,carousel,808,36,34,878
POST_0519,2024-11-23,static_image,388,93,20,501
POST_0920,2024-11-23,reels,580,28,14,622
POST_0050,2024-11-24,carousel,1096,93,24,1213
POST_0141,2024-11-24,carousel,433,116,23,572
POST_0283,2024-11-24,reels,519,39,44,602
POST_0355,2024-11-24,reels,593,16,40,649
POST_0412,2024-11-24,static_image,729,28,27,784
POST_0466,2024-11-24,reels,591,23,82,696
POST_0474,2024-11-24,reels,142,50,86,278
POST_0477,2024-11-24,carousel,1129,112,9,1250
POST_0524,2024-11-24,static_image,632,66,18,716
POST_0674,2024-11-24,reels,113,59,64,236
POST_0922,2024-11-24,reels,453,22,10,485
POST_0002,2024-11-25,static_image,854,45,40,939
POST_0189,2024-11-25,static_image,400,98,37,535
POST_0381,2024-11-25,carousel,223,62,5,290
POST_0439,2024-11-25,reels,930,56,30,1016
POST_0441,2024-11-25,carousel,356,15,24,395
POST_0451,2024-11-25,reels,701,13,86,800
POST_0550,2024-11-25,carousel,530,67,44,641
POST_0580,2024-11-25,reels,757,75,16,848
POST_0804,2024-11-25,static_image,579,19,26,624
POST_0940,2024-11-25,static_image,831,66,49,946
POST_0958,2024-11-25,reels,544,22,30,596
POST_0071,2024-11-26,reels,733,55,12,800
POST_0101,2024-11-26,static_image,251,69,49,369
POST_0237,2024-11-26,carousel,247,55,41,343
POST_0302,2024-11-26,reels,689,86,58,833
POST_0391,2024-11-26,reels,716,50,58,824
POST_0623,2024-11-26,carousel,478,24,43,545
POST_0733,2024-11-26,static_image,962,37,15,1014
POST_0849,2024-11-26,static_image,652,63,24,739
POST_0905,2024-11-26,reels,208,44,86,338
POST_0911,2024-11-26,carousel,600,112,6,718
POST_0932,2024-11-26,carousel,1105,44,13,1162
POST_0154,2024-11-27,reels,554,83,90,727
POST_0173,2024-11-27,carousel,219,18,23,260
POST_0299,2024-11-27,reels,772,30,42,844
POST_0436,2024-11-27,carousel,210,46,42,298
POST_0497,2024-11-27,static_image,976,12,31,1019
POST_0539,2024-11-27,carousel,903,100,39,1042
POST_0690,2024-11-27,reels,927,98,28,1053
POST_0790,2024-11-27,carousel,1154,74,45,1273
POST_0936,2024-11-27,static_image,528,24,7,559
POST_0965,2024-11-27,reels,835,71,84,990
POST_0012,2024-11-28,carousel,990,24,27,1041
POST_0076,2024-11-28,static_image,409,64,28,501
POST_0106,2024-11-28,carousel,630,90,39,759
POST_0279,2024-11-28,carousel,1083,100,19,1202
POST_0373,2024-11-28,carousel,868,87,21,976
POST_0429,2024-11-28,reels,871,69,98,1038
POST_0577,2024-11-28,carousel,841,93,12,946
POST_0616,2024-11-28,reels,300,38,34,372
POST_0752,2024-11-28,reels,359,38,76,473
POST_0770,2024-11-28,carousel,228,109,8,345
POST_0913,2024-11-28,reels,857,42,68,967
POST_0004,2024-11-29,static_image,353,83,44,480
POST_0073,2024-11-29,static_image,893,38,25,956
POST_0170,2024-11-29,reels,558,36,14,608
POST_0221,2024-11-29,carousel,622,90,19,731
POST_0337,2024-11-29,reels,172,24,50,246
POST_0384,2024-11-29,reels,465,20,38,523
POST_0420,2024-11-29,static_image,165,50,17,232
POST_0500,2024-11-29,carousel,1189,68,47,1304
POST_0513,2024-11-29,reels,376,37,60,473
POST_0985,2024-11-29,static_image,798,30,15,843
POST_0233,2024-11-30,reels,806,23,40,869
POST_0242,2024-11-30,reels,896,10,78,984
POST_0350,2024-11-30,static_image,386,14,23,423
POST_0353,2024-11-30,static_image,556,96,23,675
POST_0360,2024-11-30,reels,625,80,82,787
POST_0364,2024-11-30,reels,987,48,18,1053
POST_0525,2024-11-30,carousel,780,21,39,840
POST_0622,2024-11-30,carousel,794,112,48,954
POST_0634,2024-11-30,carousel,788,25,10,823
POST_0702,2024-11-30,carousel,238,115,49,402
POST_0872,2024-11-30,static_image,579,61,37,677
POST_0006,2024-12-01,static_image,445,55,47,547
POST_0036,2024-12-01,carousel,435,45,43,523
POST_0082,2024-12-01,carousel,888,117,47,1052
POST_0291,2024-12-01,static_image,217,30,26,273
POST_0332,2024-12-01,static_image,505,52,19,576
POST_0399,2024-12-01,reels,824,53,72,949
POST_0533,2024-12-01,carousel,218,72,7,297
POST_0796,2024-12-01,static_image,268,78,17,363
POST_0822,2024-12-01,carousel,406,87,39,532
POST_0827,2024-12-01,reels,883,92,44,1019
POST_0906,2024-12-01,reels,524,14,92,630
POST_0956,2024-12-01,static_image,998,30,30,1058
POST_0055,2024-12-02,static_image,599,95,48,742
POST_0218,2024-12-02,reels,123,29,82,234
POST_0347,2024-12-02,carousel,770,104,24,898
POST_0434,2024-12-02,reels,258,69,46,373
POST_0450,2024-12-02,carousel,207,87,9,303
POST_0454,2024-12-02,carousel,770,111,28,909
POST_0460,2024-12-02,reels,655,82,98,835
POST_0602,2024-12-02,carousel,127,92,41,260
POST_0687,2024-12-02,reels,918,22,46,986
POST_0791,2024-12-02,carousel,729,82,10,821
POST_0856,2024-12-02,reels,365,62,38,465
POST_0890,2024-12-02,reels,355,16,94,465
POST_0013,2024-12-03,carousel,1095,36,30,1161
POST_0111,2024-12-03,carousel,445,78,48,571
POST_0290,2024-12-03,carousel,553,67,17,637
POST_0637,2024-12-03,reels,315,32,38,385
POST_0684,2024-12-03,carousel,1185,87,33,1305
POST_0802,2024-12-03,static_image,898,51,14,963
POST_0844,2024-12-03,carousel,363,96,7,466
POST_0851,2024-12-03,carousel,1081,37,7,1125
POST_0891,2024-12-03,reels,187,77,64,328
POST_0901,2024-12-03,carousel,1017,76,36,1129
POST_0219,2024-12-04,reels,631,69,56,756
POST_0336,2024-12-04,reels,166,89,22,277
POST_0406,2024-12-04,static_image,444,31,32,507
POST_0408,2024-12-04,carousel,374,105,31,510
POST_0485,2024-12-04,carousel,213,114,32,359
POST_0540,2024-12-04,carousel,519,60,8,587
POST_0665,2024-12-04,reels,394,76,24,494
POST_0786,2024-12-04,static_image,288,45,38,371
POST_0883,2024-12-04,carousel,951,55,13,1019
POST_0909,2024-12-04,carousel,460,55,27,542
POST_0953,2024-12-04,carousel,804,96,32,932
POST_0990,2024-12-04,carousel,1142,22,23,1187
POST_0031,2024-12-05,reels,131,39,66,236
POST_0058,2024-12-05,carousel,781,90,49,920
POST_0160,2024-12-05,static_image,384,85,40,509
POST_0257,2024-12-05,reels,900,10,46,956
POST_0357,2024-12-05,carousel,240,73,33,346
POST_0402,2024-12-05,carousel,754,36,17,807
POST_0548,2024-12-05,carousel,507,52,21,580
POST_0685,2024-12-05,static_image,732,74,47,853
POST_0779,2024-12-05,reels,651,14,50,715
POST_0814,2024-12-05,static_image,208,64,5,277
POST_0876,2024-12-05,reels,705,57,28,790
POST_0924,2024-12-05,carousel,412,87,33,532
POST_0415,2024-12-06,reels,755,81,10,846
POST_0459,2024-12-06,reels,717,98,34,849
POST_0478,2024-12-06,reels,121,66,12,199
POST_0487,2024-12-06,reels,980,72,12,1064
POST_0518,2024-12-06,static_image,961,24,31,1016
POST_0529,2024-12-06,reels,711,81,78,870
POST_0737,2024-12-06,carousel,669,75,37,781
POST_0772,2024-12-06,carousel,603,115,14,732
POST_0873,2024-12-06,carousel,558,93,47,698
POST_0881,2024-12-06,carousel,206,18,47,271
POST_0983,2024-12-06,static_image,464,44,35,543
POST_0032,2024-12-07,carousel,633,46,20,699
POST_0043,2024-12-07,static_image,195,97,18,310
POST_0172,2024-12-07,carousel,144,67,20,231
POST_0264,2024-12-07,static_image,553,91,17,661
POST_0409,2024-12-07,reels,706,88,54,848
POST_0628,2024-12-07,reels,886,46,86,1018
POST_0688,2024-12-07,carousel,356,78,16,450
POST_0754,2024-12-07,reels,346,17,34,397
POST_0912,2024-12-07,carousel,894,32,34,960
POST_0961,2024-12-07,static_image,485,85,14,584
POST_0063,2024-12-08,reels,455,50,84,589
POST_0110,2024-12-08,reels,576,71,96,743
POST_0281,2024-12-08,reels,433,77,62,572
POST_0370,2024-12-08,reels,807,43,44,894
POST_0440,2024-12-08,carousel,260,64,37,361
POST_0568,2024-12-08,carousel,1027,69,46,1142
POST_0654,2024-12-08,carousel,288,20,9,317
POST_0689,2024-12-08,static_image,520,26,27,573
POST_0742,2024-12-08,reels,813,55,34,902
POST_0869,2024-12-08,static_image,347,26,47,420
POST_0937,2024-12-08,static_image,792,55,34,881
POST_0029,2024-12-09,carousel,1002,26,34,1062
POST_0042,2024-12-09,static_image,150,17,38,205
POST_0413,2024-12-09,carousel,154,57,48,259
POST_0547,2024-12-09,carousel,939,50,13,1002
POST_0551,2024-12-09,reels,687,55,38,780
POST_0569,2024-12-09,static_image,921,18,28,967
POST_0584,2024-12-09,carousel,1042,86,33,1161
POST_0700,2024-12-09,static_image,997,25,13,1035
POST_0701,2024-12-09,carousel,318,100,26,444
POST_0757,2024-12-09,reels,953,95,96,1144
POST_0917,2024-12-09,reels,778,56,46,880
POST_0087,2024-12-10,reels,668,64,32,764
POST_0131,2024-12-10,reels,366,65,14,445
POST_0137,2024-12-10,reels,553,46,34,633
POST_0191,2024-12-10,reels,790,97,90,977
POST_0375,2024-12-10,carousel,235,22,44,301
POST_0609,2024-12-10,reels,475,97,14,586
POST_0667,2024-12-10,reels,832,62,86,980
POST_0675,2024-12-10,reels,152,33,38,223
POST_0755,2024-12-10,reels,107,74,94,275
POST_0807,2024-12-10,static_image,903,90,45,1038
POST_0886,2024-12-10,static_image,287,49,40,376
POST_0116,2024-12-11,reels,392,34,10,436
POST_0287,2024-12-11,carousel,309,96,46,451
POST_0298,2024-12-11,static_image,341,78,39,458
POST_0452,2024-12-11,static_image,740,33,40,813
POST_0488,2024-12-11,carousel,1030,14,12,1056
POST_0492,2024-12-11,reels,107,33,64,204
POST_0588,2024-12-11,static_image,183,79,31,293
POST_0605,2024-12-11,static_image,526,20,42,588
POST_0840,2024-12-11,reels,768,83,42,893
POST_0959,2024-12-11,reels,627,17,88,732
POST_0964,2024-12-11,static_image,957,32,22,1011
POST_0003,2024-12-12,reels,910,36,18,964
POST_0206,2024-12-12,reels,413,31,60,504
POST_0226,2024-12-12,reels,698,51,96,845
POST_0244,2024-12-12,carousel,948,104,16,1068
POST_0252,2024-12-12,reels,616,95,76,787
POST_0254,2024-12-12,reels,513,91,42,646
POST_0324,2024-12-12,carousel,878,46,25,949
POST_0496,2024-12-12,reels,367,11,22,400
POST_0848,2024-12-12,static_image,394,38,42,474
POST_0929,2024-12-12,carousel,807,31,47,885
POST_0957,2024-12-12,reels,584,95,92,771
POST_0062,2024-12-13,static_image,937,27,25,989
POST_0085,2024-12-13,reels,965,21,46,1032
POST_0266,2024-12-13,static_image,740,97,11,848
POST_0514,2024-12-13,reels,516,94,78,688
POST_0607,2024-12-13,reels,932,40,16,988
POST_0696,2024-12-13,reels,200,57,86,343
POST_0728,2024-12-13,reels,430,24,72,526
POST_0824,2024-12-13,reels,188,29,70,287
POST_0889,2024-12-13,static_image,797,66,17,880
POST_0925,2024-12-13,static_image,739,97,30,866
POST_0934,2024-12-13,carousel,717,72,45,834
POST_0030,2024-12-14,static_image,534,65,23,622
POST_0037,2024-12-14,static_image,899,19,14,932
POST_0135,2024-12-14,carousel,592,81,38,711
POST_0162,2024-12-14,static_image,128,20,37,185
POST_0214,2024-12-14,carousel,189,14,32,235
POST_0308,2024-12-14,static_image,720,45,44,809
POST_0315,2024-12-14,reels,937,11,54,1002
POST_0510,2024-12-14,carousel,592,90,48,730
POST_0552,2024-12-14,carousel,909,42,33,984
POST_0709,2024-12-14,reels,624,46,84,754
POST_0813,2024-12-14,carousel,736,108,16,860
POST_0009,2024-12-15,carousel,1184,55,12,1251
POST_0329,2024-12-15,carousel,1042,98,5,1145
POST_0556,2024-12-15,reels,175,54,14,243
POST_0597,2024-12-15,reels,129,69,96,294
POST_0651,2024-12-15,carousel,704,96,34,834
POST_0680,2024-12-15,carousel,828,79,35,942
POST_0815,2024-12-15,carousel,687,28,40,755
POST_0948,2024-12-15,static_image,223,70,19,312
POST_0952,2024-12-15,carousel,372,87,48,507
POST_0979,2024-12-15,static_image,554,86,42,682
POST_0136,2024-12-16,static_image,137,81,9,227
POST_0148,2024-12-16,static_image,536,39,43,618
POST_0184,2024-12-16,carousel,932,68,26,1026
POST_0338,2024-12-16,static_image,677,11,39,727
POST_0411,2024-12-16,carousel,542,78,7,627
POST_0502,2024-12-16,carousel,747,24,20,791
POST_0534,2024-12-16,reels,374,82,64,520
POST_0583,2024-12-16,carousel,1003,102,19,1124
POST_0708,2024-12-16,carousel,171,67,14,252
POST_0724,2024-12-16,static_image,588,38,38,664
POST_0801,2024-12-16,reels,760,81,40,881
POST_0971,2024-12-16,carousel,367,15,36,418
POST_0049,2024-12-17,carousel,958,109,6,1073
POST_0102,2024-12-17,reels,230,46,94,370
POST_0145,2024-12-17,reels,799,16,18,833
POST_0316,2024-12-17,reels,713,90,78,881
POST_0417,2024-12-17,static_image,323,73,46,442
POST_0527,2024-12-17,reels,350,32,62,444
POST_0632,2024-12-17,static_image,239,30,15,284
POST_0646,2024-12-17,reels,782,76,28,886
POST_0765,2024-12-17,reels,598,10,72,680
POST_0914,2024-12-17,carousel,884,49,46,979
POST_0945,2024-12-17,static_image,673,13,15,701
POST_0089,2024-12-18,static_image,760,90,27,877
POST_0207,2024-12-18,static_image,614,50,46,710
POST_0449,2024-12-18,static_image,680,73,41,794
POST_0520,2024-12-18,reels,165,49,64,278
POST_0599,2024-12-18,static_image,140,72,27,239
POST_0723,2024-12-18,carousel,375,81,8,464
POST_0758,2024-12-18,carousel,624,99,40,763
POST_0761,2024-12-18,reels,863,75,24,962
POST_0861,2024-12-18,static_image,916,18,40,974
POST_0903,2024-12-18,reels,276,67,86,429
POST_0963,2024-12-18,reels,613,59,32,704
POST_0109,2024-12-19,static_image,990,48,33,1071
POST_0130,2024-12-19,carousel,814,27,41,882
POST_0278,2024-12-19,carousel,607,106,19,732
POST_0328,2024-12-19,carousel,914,90,45,1049
POST_0339,2024-12-19,reels,305,29,44,378
POST_0416,2024-12-19,carousel,736,88,8,832
POST_0490,2024-12-19,static_image,700,59,47,806
POST_0706,2024-12-19,reels,537,74,80,691
POST_0792,2024-12-19,carousel,1108,22,44,1174
POST_0879,2024-12-19,reels,969,74,62,1105
POST_0997,2024-12-19,reels,999,51,48,1098
POST_0066,2024-12-20,carousel,1167,114,25,1306
POST_0070,2024-12-20,carousel,600,42,25,667
POST_0297,2024-12-20,static_image,775,83,37,895
POST_0343,2024-12-20,reels,337,61,14,412
POST_0379,2024-12-20,static_image,680,41,48,769
POST_0707,2024-12-20,carousel,421,26,14,461
POST_0727,2024-12-20,carousel,876,16,36,928
POST_0793,2024-12-20,static_image,714,47,25,786
POST_0810,2024-12-20,carousel,607,57,21,685
POST_0867,2024-12-20,static_image,370,13,33,416
POST_0875,2024-12-20,reels,413,42,30,485
POST_0005,2024-12-21,reels,233,81,54,368
POST_0027,2024-12-21,carousel,296,114,32,442
POST_0151,2024-12-21,carousel,174,43,45,262
POST_0284,2024-12-21,reels,688,13,60,761
POST_0340,2024-12-21,reels,636,75,58,769
POST_0421,2024-12-21,carousel,718,54,26,798
POST_0458,2024-12-21,reels,731,19,40,790
POST_0615,2024-12-21,carousel,160,115,10,285
POST_0745,2024-12-21,carousel,400,50,21,471
POST_0972,2024-12-21,static_image,986,79,28,1093
POST_0994,2024-12-21,static_image,954,33,15,1002
POST_0056,2024-12-22,carousel,975,46,27,1048
POST_0121,2024-12-22,reels,944,34,22,1000
POST_0199,2024-12-22,reels,785,24,76,885
POST_0212,2024-12-22,static_image,911,91,10,1012
POST_0377,2024-12-22,static_image,825,81,19,925
POST_0562,2024-12-22,reels,382,17,46,445
POST_0647,2024-12-22,reels,419,30,40,489
POST_0691,2024-12-22,static_image,122,94,25,241
POST_0715,2024-12-22,static_image,564,67,16,647
POST_0789,2024-12-22,carousel,416,38,49,503
POST_0812,2024-12-22,carousel,288,94,10,392
POST_0065,2024-12-23,reels,477,85,54,616
POST_0223,2024-12-23,static_image,470,67,16,553
POST_0288,2024-12-23,carousel,476,78,40,594
POST_0407,2024-12-23,carousel,1056,109,6,1171
POST_0443,2024-12-23,static_image,970,18,30,1018
POST_0578,2024-12-23,carousel,1149,66,27,1242
POST_0681,2024-12-23,carousel,1152,42,22,1216
POST_0762,2024-12-23,static_image,889,36,33,958
POST_0769,2024-12-23,carousel,447,64,33,544
POST_0935,2024-12-23,static_image,817,38,23,878
POST_0941,2024-12-23,reels,933,86,98,1117
POST_0995,2024-12-23,reels,794,37,18,849
POST_0067,2024-12-24,static_image,924,40,10,974
POST_0200,2024-12-24,reels,986,53,88,1127
POST_0423,2024-12-24,carousel,135,51,24,210
POST_0482,2024-12-24,static_image,930,58,36,1024
POST_0572,2024-12-24,static_image,140,48,17,205
POST_0590,2024-12-24,reels,395,11,42,448
POST_0705,2024-12-24,reels,248,37,88,373
POST_0781,2024-12-24,static_image,853,17,45,915
POST_0839,2024-12-24,carousel,801,20,30,851
POST_0858,2024-12-24,static_image,347,31,40,418
POST_0946,2024-12-24,reels,578,39,94,711
POST_0960,2024-12-24,static_image,924,49,49,1022
POST_0060,2024-12-25,static_image,593,13,30,636
POST_0079,2024-12-25,static_image,343,90,49,482
POST_0097,2024-12-25,carousel,741,21,12,774
POST_0208,2024-12-25,reels,111,96,32,239
POST_0217,2024-12-25,carousel,1153,112,35,1300
POST_0220,2024-12-25,reels,788,60,72,920
POST_0277,2024-12-25,reels,913,52,98,1063
POST_0319,2024-12-25,carousel,1132,48,20,1200
POST_0838,2024-12-25,carousel,1069,109,14,1192
POST_0841,2024-12-25,reels,617,67,18,702
POST_0847,2024-12-25,reels,121,35,94,250
POST_0020,2024-12-26,static_image,309,43,31,383
POST_0096,2024-12-26,reels,490,23,38,551
POST_0404,2024-12-26,reels,746,32,96,874
POST_0442,2024-12-26,static_image,498,79,18,595
POST_0498,2024-12-26,reels,974,49,84,1107
POST_0627,2024-12-26,reels,203,95,56,354
POST_0658,2024-12-26,reels,457,84,78,619
POST_0771,2024-12-26,carousel,255,12,30,297
POST_0800,2024-12-26,static_image,627,31,25,683
POST_0846,2024-12-26,reels,735,33,28,796
POST_0880,2024-12-26,reels,875,60,92,1027
POST_0939,2024-12-26,reels,617,85,88,790
POST_0091,2024-12-27,carousel,678,117,16,811
POST_0190,2024-12-27,reels,524,17,30,571
POST_0286,2024-12-27,static_image,207,83,43,333
POST_0386,2024-12-27,reels,360,14,68,442
POST_0468,2024-12-27,static_image,698,99,41,838
POST_0506,2024-12-27,carousel,763,14,37,814
POST_0573,2024-12-27,static_image,593,28,15,636
POST_0645,2024-12-27,static_image,819,31,33,883
POST_0805,2024-12-27,carousel,1060,92,29,1181
POST_0930,2024-12-27,carousel,420,14,19,453
POST_0019,2024-12-28,reels,174,47,12,233
POST_0213,2024-12-28,reels,822,31,82,935
POST_0274,2024-12-28,reels,728,35,58,821
POST_0275,2024-12-28,carousel,483,55,19,557
POST_0313,2024-12-28,carousel,1050,97,7,1154
POST_0545,2024-12-28,static_image,878,73,25,976
POST_0611,2024-12-28,static_image,529,73,31,633
POST_0672,2024-12-28,reels,173,19,80,272
POST_0783,2024-12-28,reels,604,77,38,719
POST_0854,2024-12-28,carousel,650,81,6,737
POST_0908,2024-12-28,static_image,513,66,26,605
POST_0010,2024-12-29,static_image,205,40,13,258
POST_0143,2024-12-29,carousel,554,64,29,647
POST_0153,2024-12-29,carousel,928,94,23,1045
POST_0356,2024-12-29,carousel,430,15,43,488
POST_0362,2024-12-29,reels,830,30,84,944
POST_0396,2024-12-29,static_image,621,24,21,666
POST_0479,2024-12-29,reels,197,25,86,308
POST_0670,2024-12-29,carousel,456,114,35,605
POST_0897,2024-12-29,static_image,902,77,9,988
POST_0970,2024-12-29,static_image,889,83,43,1015
POST_0057,2024-12-30,carousel,1177,108,18,1303
POST_0161,2024-12-30,static_image,326,61,16,403
POST_0260,2024-12-30,reels,803,79,26,908
POST_0334,2024-12-30,reels,693,54,78,825
POST_0374,2024-12-30,carousel,628,12,6,646
POST_0392,2024-12-30,reels,218,71,28,317
POST_0625,2024-12-30,carousel,698,26,38,762
POST_0659,2024-12-30,static_image,287,86,49,422
POST_0731,2024-12-30,carousel,591,64,23,678
POST_0864,2024-12-30,reels,275,47,42,364
POST_0078,2024-12-31,reels,647,29,46,722
POST_0080,2024-12-31,static_image,581,82,30,693
POST_0103,2024-12-31,reels,282,96,96,474
POST_0197,2024-12-31,carousel,825,42,26,893
POST_0603,2024-12-31,carousel,350,67,24,441
POST_0644,2024-12-31,static_image,936,22,35,993
POST_0679,2024-12-31,reels,949,84,90,1123
POST_0751,2024-12-31,static_image,969,91,30,1090
POST_0830,2024-12-31,reels,196,14,64,274
POST_0853,2024-12-31,carousel,696,68,10,774
POST_0955,2024-12-31,reels,500,25,54,579
POST_0044,2025-01-01,reels,590,25,16,631
POST_0246,2025-01-01,static_image,910,98,33,1041
POST_0267,2025-01-01,carousel,988,28,5,1021
POST_0301,2025-01-01,static_image,554,41,15,610
POST_0305,2025-01-01,reels,736,48,90,874
POST_0526,2025-01-01,carousel,367,109,37,513
POST_0549,2025-01-01,reels,827,74,24,925
POST_0721,2025-01-01,static_image,406,82,36,524
POST_0744,2025-01-01,reels,192,17,96,305
POST_0780,2025-01-01,reels,231,32,92,355
POST_0857,2025-01-01,static_image,761,60,25,846
POST_0877,2025-01-01,reels,649,28,80,757
POST_0011,2025-01-02,reels,150,38,36,224
POST_0230,2025-01-02,reels,244,98,64,406
POST_0555,2025-01-02,static_image,554,37,8,599
POST_0671,2025-01-02,carousel,338,38,36,412
POST_0743,2025-01-02,static_image,833,12,34,879
POST_0760,2025-01-02,static_image,270,94,28,392
POST_0821,2025-01-02,carousel,458,106,10,574
POST_0910,2025-01-02,carousel,925,66,27,1018
POST_0927,2025-01-02,reels,404,76,22,502
POST_0949,2025-01-02,carousel,282,98,41,421
POST_0112,2025-01-03,static_image,476,19,34,529
POST_0304,2025-01-03,carousel,908,91,46,1045
POST_0349,2025-01-03,carousel,170,13,27,210
POST_0383,2025-01-03,carousel,892,34,25,951
POST_0598,2025-01-03,reels,899,76,14,989
POST_0635,2025-01-03,carousel,1178,33,30,1241
POST_0682,2025-01-03,reels,393,90,54,537
POST_0747,2025-01-03,static_image,767,79,45,891
POST_0748,2025-01-03,static_image,351,57,30,438
POST_0907,2025-01-03,static_image,564,85,27,676
POST_0926,2025-01-03,carousel,204,26,9,239
POST_0007,2025-01-04,reels,240,71,44,355
POST_0008,2025-01-04,carousel,866,82,47,995
POST_0026,2025-01-04,carousel,1137,111,45,1293
POST_0045,2025-01-04,carousel,337,112,18,467
POST_0114,2025-01-04,carousel,945,14,49,1008
POST_0240,2025-01-04,static_image,981,87,6,1074
POST_0351,2025-01-04,reels,877,98,12,987
POST_0567,2025-01-04,static_image,503,99,43,645
POST_0871,2025-01-04,carousel,934,57,27,1018
POST_0918,2025-01-04,reels,481,37,56,574
POST_0104,2025-01-05,static_image,626,13,33,672
POST_0359,2025-01-05,static_image,673,16,31,720
POST_0649,2025-01-05,reels,156,56,78,290
POST_0794,2025-01-05,carousel,373,14,26,413
POST_0942,2025-01-05,reels,434,29,66,529
POST_0976,2025-01-05,carousel,604,52,19,675
